# settings.py
MAP = [
    ['1','1','1','1','1','1','1','1','1','1','1','1','1','1','1','1','1','1','1'],
    ['1',' ',' ',' ',' ',' ',' ',' ',' ',' ',' ',' ',' ',' ',' ',' ',' ',' ','1'],
    ['1','B','1','1',' ','1','1','1',' ','1',' ','1','1','1',' ','1','1','B','1'],
    ['1',' ',' ',' ',' ','1',' ',' ',' ','1',' ',' ',' ','1',' ',' ',' ',' ','1'],
    ['1','1',' ','1',' ','1',' ','1',' ','1',' ','1',' ','1',' ','1',' ','1','1'],
    ['1',' ',' ','1',' ',' ',' ','1',' ',' ',' ','1',' ',' ',' ','1',' ',' ','1'],
    ['1',' ','1','1','1','1',' ','1','1','1','1','1',' ','1','1','1','1',' ','1'],
    ['1',' ',' ',' ',' ',' ',' ',' ',' ','r',' ',' ',' ',' ',' ',' ',' ',' ','1'],
    ['1','1',' ','1','1','1',' ','1','1','-','1','1',' ','1','1','1',' ','1','1'],
    [' ',' ',' ',' ',' ','1',' ','1','s','p','o','1',' ','1',' ',' ',' ',' ',' '],
    ['1','1',' ','1',' ','1',' ','1','1','1','1','1',' ','1',' ','1',' ','1','1'],
    ['1',' ',' ','1',' ',' ',' ',' ',' ',' ',' ',' ',' ',' ',' ','1',' ',' ','1'],
    ['1',' ','1','1','1','1',' ','1','1','1','1','1',' ','1','1','1','1',' ','1'],
    ['1',' ',' ',' ',' ',' ',' ',' ',' ',' ',' ',' ',' ',' ',' ',' ',' ',' ','1'],
    ['1','1','1',' ','1','1','1',' ','1','1','1',' ','1','1','1',' ','1','1','1'],
    ['1',' ',' ',' ','1',' ',' ',' ',' ','P',' ',' ',' ',' ','1',' ',' ',' ','1'],
    ['1','B','1',' ','1',' ','1',' ','1','1','1',' ','1',' ','1',' ','1','B','1'],
    ['1',' ','1',' ',' ',' ','1',' ',' ',' ',' ',' ','1',' ',' ',' ','1',' ','1'],
    ['1',' ','1','1','1',' ','1','1','1',' ','1','1','1',' ','1','1','1',' ','1'],
    ['1',' ',' ',' ',' ',' ',' ',' ',' ',' ',' ',' ',' ',' ',' ',' ',' ',' ','1'],
    ['1','1','1','1','1','1','1','1','1','1','1','1','1','1','1','1','1','1','1']
]
BOARD_RATIO = (len(MAP[0]), len(MAP))
CHAR_SIZE = 32
WIDTH, HEIGHT = (BOARD_RATIO[0] * CHAR_SIZE, BOARD_RATIO[1] * CHAR_SIZE)
NAV_HEIGHT = 64
PLAYER_SPEED = CHAR_SIZE // 4
GHOST_SPEED = 4

  #example map found from research